1  2  2  2  2  2  2  2  2  2  2  2  2  2  2  2  2  2  2  2  2  2  2  2  2  2  2  2  2 3
28 29 29 29 462 463 464 29 29 29 29 29 29 29 29 29 29 29 29 29 29 29 29 29 29 29 29 29 29 30
28 29 29 29 462 463 464 29 29 29 29 29 29 29 29 29 29 29 29 29 29 29 29 29 29 29 29 29 29 30
28 29 29 29 462 463 464 29 29 29 29 29 29 29 29 29 29 29 29 29 29 29 29 29 29 29 29 29 29 30
28 29 29 29 462 463 464 29 29 29 29 29 29 29 29 29 29 29 29 29 29 29 29 29 29 29 29 29 29 30
28 29 29 29 462 463 464 29 29 29 29 29 29 29 29 29 29 29 29 29 29 29 29 29 29 29 29 29 29 30
28 29 29 29 462 463 464 29 29 29 29 29 29 29 29 29 29 29 29 29 29 29 29 29 29 29 29 29 29 30
28 29 29 29 462 463 464 29 29 29 29 29 29 29 29 29 29 29 29 29 29 29 29 29 29 29 29 29 29 30
28 29 29 29 462 463 464 29 29 29 29 29 29 29 29 29 29 29 29 29 29 29 29 29 29 29 29 29 29 30
28 29 29 29 462 463 464 29 29 29 29 29 29 29 29 29 29 29 29 29 29 29 29 29 29 29 29 29 29 30
28 29 29 29 462 463 464 29 29 29 29 29 29 29 29 29 29 29 29 29 29 29 29 29 29 29 29 29 29 30
28 29 29 29 462 463 464 29 29 29 29 29 29 29 29 29 29 29 29 29 29 29 29 29 29 29 29 29 29 30
28 29 29 29 462 463 464 29 29 29 29 29 29 29 29 29 29 29 29 29 29 29 29 29 29 29 29 29 29 30
28 29 29 29 435 436 437 29 29 29 29 29 29 29 29 29 29 29 29 29 29 29 29 29 29 29 29 29 29 30
406 407 407 407 468 469 467 407 407 407 407 407 406 407 407 407 407 407 407 407 407 407 407 407 407 407 407 407 407 30
433 434 434 434 434 434 434 434 434 434 434 434 433 434 434 434 434 434 434 434 434 434 434 434 434 434 434 434 434 30
460 461 461 461 461 461 461 461 461 461 461 461 460 461 461 461 461 461 461 461 461 461 461 461 461 461 461 461 461 30
28 29 29 29 29 29 29 29 29 29 29 29 462 463 464 29 29 29 29 29 29 29 29 29 29 29 29 29 29 30
28 29 29 29 29 29 29 29 29 29 29 29 462 463 464 29 29 29 29 29 29 29 29 29 29 29 29 29 29 30
28 29 29 29 29 29 29 29 29 29 29 29 462 463 464 29 29 29 29 29 29 29 29 29 29 29 29 29 29 30
28 29 29 29 29 29 29 29 29 29 29 29 462 463 464 29 29 29 29 29 29 29 29 29 29 29 29 29 29 30
28 29 29 29 29 29 29 29 29 29 29 29 462 463 464 29 29 29 29 29 29 29 29 29 29 29 29 29 29 30
28 29 29 29 29 29 29 29 29 29 29 29 435 436 437 29 29 29 29 29 29 29 29 29 29 29 29 29 29 30
406 407 407 407 407 407 407 407 407 407 468 469 467 29 29 29 29 29 29 29 29 29 29 29 29 29 29 30
433 434 434 434 434 434 434 434 434 434 469 29 29 29 29 29 29 29 29 29 29 29 29 29 29 29 29 30
460 461 461 461 461 461 461 29 29 29 29 29 29 29 29 29 29 29 29 29 29 29 29 29 29 29 29 30
28 29 29 29 29 29 29 439 29 29 29 29 29 29 29 29 29 29 29 29 29 29 29 29 29 29 29 29 29 30
28 29 29 29 29 29 29 29 29 29 29 29 29 29 29 29 29 29 29 29 29 29 29 29 29 29 29 29 29 30
28 29 29 29 29 29 29 29 29 29 29 29 29 29 29 29 29 29 29 29 29 29 29 29 29 29 29 29 29 30
55 56 56 56 56 56 56 56 56 56 56 56 56 56 56 56 56 56 56 56 56 56 56 56 56 56 56 56 56 57