37  37  37  38  438 407 439 2   2   2   2   2   2   2   2   2   2   2   2   2   2   2   2   2   438 407 439 2   2   3 
37  37  37  38  462 463 464 29  29  29  29  29  29  29  29  29  29  29  29  29  29  29  29  29  462 463 464 29  29  30
37  37  37  38  462 463 464 29  29  29  29  29  29  29  29  29  29  29  29  29  29  29  29  29  462 463 464 29  29  30
37  37  37  38  462 463 464 29  29  29  29  29  29  29  29  29  29  29  29  29  29  29  29  29  435 436 437 29  29  30
37  37  37  38  462 463 464 29  29  29  82  83  83  83  83  84  29  29  29  29  29  29  29  29  462 463 464 29  29  30
37  37  37  38  462 463 464 29  29  29  109 110 110 110 110 111 29  29  29  29  29  29  29  29  462 463 464 29  29  30
37  37  37  38  462 463 464 29  29  29  136 137 137 137 137 138 29  29  29  29  29  29  29  29  462 463 464 29  29  30
37  37  37  38  462 463 464 29  29  29  17  18  19  19  20  17  29  29  29  29  29  29  29  29  462 463 464 29  29  30
37  37  37  38  462 463 464 29  29  29  44  45  46  46  47  44  29  29  29  29  29  29  29  29  462 463 464 29  29  30
37  37  37  38  462 463 464 29  29  29  71  72  443 72  74  71  29  29  29  29  29  29  29  29  462 463 464 29  29  30
37  37  37  38  462 463 464 29  29  29  44  45  46  46  47  44  29  29  29  29  29  29  29  29  462 463 464 29  29  30
37  37  37  38  462 463 464 29  29  29  98  99  100 100 101 98  29  29  29  29  29  29  29  29  462 463 464 29  29  30
37  37  37  38  462 463 464 29  29  29  29  29  29  29  29  29  29  29  29  29  29  29  29  29  462 463 464 29  29  30
64   64  64  65 435 436 437 29  29  29  29  29  29 29   29  29  29  29  29  29  29  29  29  29  435 436 437 29  29  30
438 407 407 406 468 469 467 407 407 407 407 406 407 407 407 407 407 407 407 407 407 407 407 406 468 442 467 406 407 439
462 434 434 433 434 434 434 434 434 434 434 433 434 434 434 434 434 434 434 434 434 434 434 433 442 442 442 433 434 464
465 461 461 460 461 461 461 461 461 461 461 460 441 442 440 461 461 461 461 461 461 461 461 460 441 442 440 460 461 466
28  82  83  83  83  84  29  29  29  29  29  29  462 463 464 29  29  29  29  29  29  29  29  29  435 436 437 29  29  30
28  109 110 110 110 111 29  29  29  29  29  29  462 463 464 29  29  29  29  29  29  29  29  29  462 463 464 29  29  30
28  136 137 137 137 138 29  29  29  29  29  29  462 463 464 29  29  82  83  83  83  84  29  29  462 463 464 29  29  30
28  17  18  19  19  17  29  29  29  29  29  29  462 463 464 29  29  109 110 110 110 111 29  29  462 463 464 29  29  30
28  44  45  45  46  44  29  29  29  29  29  29  462 463 464 29  29  136 137 137 137 138 29  29  462 463 464 29  29  30
28  71  72  443 74  71  29  29  29  29  29  29  462 463 464 29  29  17  18  19  19  17  29  29  462 463 464 29  29  30
28  98  99  100 101 98  29  29  29  29  29  29  435 436 437 29  29  44  45  45  46  44  29  29  462 463 464 29  29  30
438 407 407 407 407 407 406 407 407 407 407 407 468 463 464 29  29  71  72  443 74  71  29  29  462 463 464 29  29  30
462 434 434 434 434 434 433 434 434 434 434 434 434 469 464 29  29  98  99  100 101 98  29  29  435 436 437 29  29  30
465 461 461 461 461 461 460 461 461 461 461 461 461 461 466 29  29  29  29  29  29  29  29  29  462 463 464 29  29  30
28  29  29  29  29  29  29  29  29  29  29  29  29  29  29  29  29  29  29  29  29  29  29  29  462 463 464 29  29  30
28  29  29  29  29  29  29  29  29  29  29  29  29  29  29  29  29  29  29  29  29  29  29  29  465 461 466 29  29  30
28  29  29  29  29  29  29  29  29  29  29  29  29  29  29  29  29  29  29  29  29  29  29  29  462 463 464 29  29  30
55  56  56  56  56  56  56  56  56  56  56  56  56  56  56  56  56  56  56  56  56  56  56  56  465 461 466 56  56  57
