1  2  2  2  2  2  2  2  2  3 
28 29 29 29 29 29 29 29 29 30
28 29 29 29 29 29 29 29 29 30
28 29 29 29 443 29 29 29 29 30
28 29 29 29 29 29 29 29 29 30
28 29 29 29 29 29 29 29 29 30
28 29 29 29 29 29 29 29 29 30
28 29 29 29 29 29 29 29 29 30
28 29 29 29 29 29 29 29 29 30
55 56 56 56 56 56 56 56 56 57
55 56 56 56 56 56 56 56 56 57
